NO  ./path_to_the_north_texture

SO      ./path_to_the_south_texture
      WE        ./path_to_the_west_text ure
              EA       ./path_to_the_west_texture



F                          220,100,0  
    C          225,30,0


1111111111111111111111111
1000000000110000000000011
1011000001110000000000001
1001000000000000000000011
1111111110111000011100001
100000000011010001110111111111111
11101111111111111111111111111111
10101
101111111111111
100000000000E011111111111111
100000000000000011010100101
11000001110101011111011110111
111101111110101101111010001
111111111111111111111111111