NO ./path_to_the_north_texture

SO      ./path_to_the_south_texture
      WE        ./path_to_the_west_text ure
              EA       ./path_to_the_west_texture



F                          220,100,0  
    C          225,30,0

    1111
     111111111111111111111111
11111100000110000000000011
1E1100000111000000000001
1111000000000000000000011
1111111110111000011100001
100000000011010001110111111111111
11101111111111111111111 111111111
1111

11111111111111111111111111



11111111111111111111111111
11111

111111111111111
1000000000000011111111111111
100000000000000011010100101
11000001110101011111011110111
111101111110101101111010001
11111111111111111111111111