C  255,37, 12

    

NO ./path_to_the_north_texture
SO      ./path_to_the_south_texture
	  WE        ./path_to_the_west_text ure
	   

			  EA       ./path_to_the_west_texture





F 220,0,66



  



    


1111111111
100111111111
	11N001001
1111111111111111
		1111111111111111111111111111111111111
	

1111111






        



